1 1 1 1 1 1 1 1 1 1 1 1 1 1 1 1 1 1 1 1 1 1
1 0 0 1 0 0 1 3 0 0 0 0 0 0 0 0 0 0 0 1 7 1
1 0 10 1 0 0 1 0 0 0 0 0 0 2 0 0 0 0 0 1 8 1
1 0 0 1 0 0 1 0 0 0 0 0 1 1 1 1 1 0 0 1 1 1
1 0 0 0 0 0 1 0 0 0 0 0 1 0 0 0 1 0 0 1 1 1
1 0 0 0 2 0 1 0 3 0 0 0 1 0 3 0 1 0 0 1 1 1
1 1 1 1 0 0 1 0 0 0 0 0 1 0 0 0 0 0 0 1 4 1
1 3 0 1 0 0 1 0 0 0 0 0 1 0 0 21 0 0 0 1 4 1
1 0 0 1 0 0 1 0 0 1 1 1 1 0 0 0 1 0 0 1 4 1
1 0 0 1 0 0 1 0 0 0 0 0 0 0 0 0 1 0 0 1 1 1
1 0 0 1 0 0 1 0 0 0 0 0 0 0 0 0 1 0 0 1 1 1
1 0 0 1 0 0 1 1 1 1 1 1 1 0 0 1 1 0 0 1 1 1
1 0 0 0 0 0 0 0 0 0 0 0 0 0 0 1 0 0 0 1 0 1
1 20 0 0 0 0 0 0 0 0 0 3 0 0 0 1 0 0 0 1 0 1
1 0 0 1 0 0 0 0 0 0 0 0 0 0 0 1 0 2 0 1 0 1
1 0 0 1 2 0 0 0 0 0 0 0 0 0 0 1 0 0 0 1 0 1
1 0 0 1 0 0 1 1 1 1 1 1 1 0 0 1 1 1 1 1 0 1
1 0 0 1 0 0 0 0 0 0 0 0 0 0 0 0 0 0 3 1 0 1
1 0 2 1 0 3 0 0 0 0 0 0 0 0 0 0 0 0 0 1 1 1
1 1 1 1 1 1 1 1 1 1 1 1 1 1 1 1 1 1 1 1 1 1